60,1,61,61,1,61,61,1,61,62
-1,28,-1,-1,28,-1,-1,23,-1,-1
-1,28,-1,-1,28,-1,-1,23,-1,-1
-1,23,-1,-1,23,-1,-1,23,-1,-1
-1,23,-1,9,22,-1,9,22,-1,-1
-1,23,-1,-1,28,-1,-1,28,-1,-1
-1,20,62,-1,23,-1,-1,28,-1,-1
-1,23,-1,9,179,29,61,22,-1,-1
-1,23,-1,-1,23,-1,-1,23,-1,-1
60,41,109,45,41,45,109,41,61,62
