165,165,165,165,10,-1,-1,-1,-1,63
184,184,204,184,-1,-1,-1,-1,-1,-1
164,164,224,164,-1,-1,-1,-1,-1,-1
164,164,164,164,-1,-1,-1,-1,-1,-1
184,184,204,184,-1,-1,-1,-1,-1,-1
164,164,224,164,165,10,-1,-1,-1,-1
164,164,164,164,164,-1,-1,-1,-1,-1
184,184,184,184,185,-1,-1,-1,-1,-1
164,164,164,164,205,-1,-1,-1,-1,-1
60,61,61,61,61,61,61,61,61,62
